-------------------------------------------------------------------
|                                                                 |
|                                                                 |
|---------------------------------                                |
|                                |                                |
|                                |                                |
|--------------------------      |                                |
|                         |      |                                |
|                         |      |                                |
|                         |      |                                |
|                         |      |                                |
|                         |      |                                |
|                         |      |                                |
|                         |      |                                |
|                         |      |                                |
|                         |      |                                |
|                         |      |------------------------------- |
|                         |                                       |
|                                                                 |
-------------------------------------------------------------------